F 255,255,255          
C 240,170,0   				

NO ./assets/wall.xpm
SO ./assets/ground.xpm           
WE ./assets/purplestone.xpm             
EA ./assets/greystone.xpm             

1111111111 11111111111111
1E00000001110000000000001  11111
100000000000000000000000111101011 
100000000000000000000000000000001 
100000000000000000000000000000001 
100000000000000000000000000000001 
100000000000000000000000000000001 
100000000111111110000000000000001
1000000001      10000000001111111   
1111000001      10001000001111
1000000001      10000000000001
100000111111111110000001000111
1000000000000000000000000001
1000000000000000000000000001
1000000111111100000000000001
1000000100000000000000000001
1000000100000000000000000001
1111111111111111111111111111
