C 2    ,60 ,	100           
NO ./assets/eagle.xpm
SO ./assets/greystone.xpm
EA ./assets/red.xpm
WE ./assets/purplestone.xpm

F  000, 000, 00

111111111111111111111111111111
111111111000000000000000011111
100000000000000000111000100001
111000100000000000000000001111
100001111111000000000000111111
1111111000000000W0000000000001
111100000000001100000000000011
111111111111111111111100111111
110000000000011110000000000011
100000000000111000000000000011
110000000000111000000000001111
110000000001111000000000000111
111111111111111111111111111111
